x     x        xxx x   x   x  x          
    x         x     x  xx x    x    x x 
x              x x x xx         x       
x              x     x x x  x   x       
 xxx     xx     x        x              
     x    x           x   x x    x    xx
x     x   x   x xx                x     
 xx     x             x        xxxx  x  
      xxx          x          x  xx    x
x x x                  x      x   x     
x      x    x x               xxx    x  
x       x  x xx                   x   x 
      x x         x x     x    xx       
       xx     x    xx x  x    xx        
       x     x x       xx     x       x 
 x  x       x   x x  x              x   
    x  x  x  x   x      x   xxx   x     
x    x x     x   x x x  x    x x       x
   x     x     x   x  x  x          x   
  xxx  x      x   x               x x x 
                x   x          xx xx    
  x   x         xx         xx  x    x   
xxx      x        x       x     x  xxx x
   x       xxxx      xx  xx      x x    
   x      x          x                x 
   xx x    x x  x x  xx   xx xxx     x  
              x   xx    x    x  x       
x x  x  x x x  x      x     xx  x  x  x 
x    x x  x   x       x             xx  
     x x            xx        xx  x     
        x   x   xx   x         x       x
x         xx     x   x  x     x     x   
     xx xx                x   xx x      
    x  x      x          x  x   xx   x  
      x               x                 
  x  x    x     x   xx xxx     x      x 
 x       x x   x xxx     x xx     x     
 xx       x         x      x       x    
x x     x    xx xx     x x  x      x    
  x x   x x  x      x x                  
