xxxxxxxxxx
x        x
x    a   x
x x      x
x x      x
x x      x
x x      x
x    b   x
x        x
xxxxxxxxxx